{
    "1": {"x": 0, "y": 0},
    "2": {"x": 0, "y": 1},
    "3": {"x": 0, "y": 2},
    "4": {"x": 0, "y": 3},
    "5": {"x": 0, "y": 4},
    "6": {"x": 0, "y": 5}
}